"aa" = (/turf/space,/area/space)
"ab" = (/turf/simulated/wall/r_wall/hull,/area/space)
"ac" = (/obj/machinery/cryopod{dir = 4},/turf/simulated/floor/tiled/white/monotile,/area/space)
"ad" = (/obj/effect/landmark/start/ship_cargo_cap_civ,/turf/simulated/floor/tiled/white,/area/space)
"ae" = (/obj/structure/lattice,/turf/space,/area/space)
"af" = (/obj/effect/landmark/start/ship_cap_civ,/turf/simulated/floor/tiled/white,/area/space)
"ag" = (/obj/machinery/cryopod,/turf/simulated/floor/tiled/white/monotile,/area/space)
"ah" = (/turf/simulated/floor/tiled/techfloor,/area/space)
"ai" = (/turf/simulated/wall/r_wall/prepainted,/area/space)
"aj" = (/turf/simulated/floor/tiled/techmaint,/area/space)
"ak" = (/turf/simulated/floor/tiled/dark,/area/space)
"al" = (/obj/machinery/door/airlock,/turf/simulated/floor/tiled,/area/space)
"am" = (/turf/simulated/floor/tiled/dark/monotile,/area/space)
"an" = (/turf/simulated/floor/carpet,/area/space)
"ao" = (/obj/machinery/door/airlock/multi_tile/civilian,/turf/simulated/floor/tiled/white,/area/space)
"ap" = (/turf/simulated/floor/tiled/white,/area/space)
"aq" = (/obj/machinery/atmospherics/pipe/tank/hydrogen,/turf/simulated/floor/tiled/techfloor,/area/space)
"ar" = (/obj/machinery/atmospherics/pipe/simple/visible/fuel{dir = 6},/turf/simulated/floor/tiled/techfloor,/area/space)
"as" = (/obj/machinery/atmospherics/unary/engine{dir = 8},/turf/simulated/wall/r_wall/hull,/area/space)
"at" = (/obj/machinery/door/airlock/external/glass,/turf/simulated/floor/tiled/techfloor,/area/space)
"au" = (/obj/structure/table/marble,/turf/simulated/floor/tiled/dark/monotile,/area/space)
"av" = (/turf/simulated/floor/tiled/monotile,/area/space)
"aw" = (/obj/machinery/atmospherics/pipe/manifold/visible/fuel{dir = 8},/turf/simulated/floor/tiled/techfloor,/area/space)
"ax" = (/obj/structure/bed/chair{dir = 4},/turf/simulated/floor/tiled/dark/monotile,/area/space)
"ay" = (/obj/effect/wallframe_spawn/reinforced,/turf/simulated/floor/tiled,/area/space)
"az" = (/turf/simulated/floor/tiled,/area/space)
"aA" = (/obj/machinery/atmospherics/pipe/simple/visible/fuel,/turf/simulated/floor/tiled/techfloor,/area/space)
"aB" = (/obj/structure/bed/chair{dir = 8},/turf/simulated/floor/tiled/dark/monotile,/area/space)
"aC" = (/obj/machinery/door/airlock/external/glass,/turf/simulated/floor/tiled,/area/space)
"aD" = (/obj/machinery/door/airlock/civilian,/turf/simulated/floor/tiled,/area/space)
"aE" = (/obj/machinery/door/airlock/glass,/turf/simulated/floor/tiled/techfloor,/area/space)
"aF" = (/obj/machinery/door/airlock/engineering,/turf/simulated/floor/tiled,/area/space)
"aG" = (/obj/machinery/atmospherics/pipe/simple/visible/fuel{dir = 4},/turf/simulated/floor/tiled/techfloor,/area/space)
"aH" = (/obj/machinery/atmospherics/pipe/manifold/visible/fuel{dir = 4},/turf/simulated/floor/tiled/techfloor,/area/space)
"aI" = (/obj/machinery/door/airlock,/turf/simulated/floor/tiled/techmaint,/area/space)
"aJ" = (/obj/structure/closet/boxinggloves,/turf/simulated/floor/tiled/monotile,/area/space)
"aK" = (/obj/structure/closet/jcloset,/turf/simulated/floor/tiled/monotile,/area/space)
"aL" = (/obj/structure/closet/lasertag/blue,/turf/simulated/floor/tiled/monotile,/area/space)
"aM" = (/obj/structure/closet/wardrobe/xenos,/turf/simulated/floor/tiled/monotile,/area/space)
"aN" = (/obj/structure/closet/wardrobe/chaplain_black,/turf/simulated/floor/tiled/monotile,/area/space)
"aO" = (/obj/machinery/constructable_frame,/turf/simulated/floor/tiled/monotile,/area/space)
"aP" = (/obj/machinery/floodlight,/turf/simulated/floor/tiled/monotile,/area/space)
"aQ" = (/obj/machinery/autolathe,/turf/simulated/floor/tiled/monotile,/area/space)
"aR" = (/obj/structure/closet/bombcloset,/turf/simulated/floor/tiled/monotile,/area/space)
"aS" = (/obj/structure/closet/firecloset,/turf/simulated/floor/tiled/monotile,/area/space)
"aT" = (/obj/structure/closet/lasertag/red,/turf/simulated/floor/tiled/monotile,/area/space)
"aU" = (/obj/structure/closet/masks,/turf/simulated/floor/tiled/monotile,/area/space)
"aV" = (/obj/structure/closet/wardrobe/pink,/turf/simulated/floor/tiled/monotile,/area/space)
"aW" = (/obj/structure/closet/wardrobe/mixed,/turf/simulated/floor/tiled/monotile,/area/space)
"aX" = (/obj/structure/table/rack,/obj/random,/turf/simulated/floor/tiled/monotile,/area/space)
"aY" = (/obj/machinery/door/airlock/multi_tile/civilian,/turf/simulated/floor/tiled,/area/space)
"aZ" = (/obj/machinery/atmospherics/pipe/tank/hydrogen{dir = 1},/turf/simulated/floor/tiled/techfloor,/area/space)
"ba" = (/obj/machinery/atmospherics/pipe/simple/visible/fuel{dir = 5},/turf/simulated/floor/tiled/techfloor,/area/space)
"bb" = (/obj/structure/ore_box,/turf/simulated/floor/tiled/monotile,/area/space)
"bc" = (/obj/structure/closet/radiation,/turf/simulated/floor/tiled/monotile,/area/space)
"bd" = (/obj/structure/closet/wardrobe/black,/turf/simulated/floor/tiled/monotile,/area/space)
"be" = (/obj/structure/closet/wardrobe/red,/turf/simulated/floor/tiled/monotile,/area/space)
"bf" = (/obj/structure/closet/wardrobe/suit,/turf/simulated/floor/tiled/monotile,/area/space)
"bg" = (/obj/structure/skele_stand,/turf/simulated/floor/tiled/monotile,/area/space)
"bh" = (/obj/structure/plushie,/turf/simulated/floor/tiled/monotile,/area/space)
"bi" = (/obj/structure/closet/wardrobe/tactical,/turf/simulated/floor/tiled/monotile,/area/space)
"bj" = (/obj/structure/closet/wardrobe/white,/turf/simulated/floor/tiled/monotile,/area/space)
"bk" = (/obj/machinery/icecream_vat,/turf/simulated/floor/tiled/monotile,/area/space)

(1,1,1) = {"
aaaaaaaaaaaaaaaaaaaaaaaaaaaaaaaaaaaaaaaaaaaaaaaaaaaaaaaaaaaaaaaaaaaaaaaaaaaaaaaaaaaaaaaaaaaaaaaaaaaaaaaaaaaaaaaaaaaaaaaaaaaaaaaaaaaaaaaaaaaaaaaaaaaaaa
aaaaaaaaaaaaaaaaaaaaaaaaaaaaaaaaaaaaaaaaaaaaaaaaaaaaaaaaaaaaaaaaaaaaaaaaaaaaaaaaaaaaaaaaaaaaaaaaaaaaaaaaaaaaaaaaaaaaaaaaaaaaaaaaaaaaaaaaaaaaaaaaaaaaaa
aaaaaaaaaaaaaaaaaaaaaaaaaaaaaaaaaaaaaaaaaaaaaaaaaaaaaaaaaaaaaaaaaaaaaaaaaaaaaaaaaaaaaaaaaaaaaaaaaaaaaaaaaaaaaaaaaaaaaaaaaaaaaaaaaaaaaaaaaaaaaaaaaaaaaa
aaaaaaaaaaaaaaaaaaaaaaaaaaaaaaaaaaaaaaaaaaaaaaaaaaaaaaaaaaaaaaaaaaaaaaaaaaaaaaaaaaaaaaaaaaaaaaaaaaaaaaaaaaaaaaaaaaaaaaaaaaaaaaaaaaaaaaaaaaaaaaaaaaaaaa
aaaaaaaaaaaaaaaaaaaaaaaaaaaaaaaaaaaaaaaaaaaaaaaaaaaaaaaaaaaaaaaaaaaaaaaaaaaaaaaaaaaaaaaaaaaaaaaaaaaaaaaaaaaaaaaaaaaaaaaaaaaaaaaaaaaaaaaaaaaaaaaaaaaaaa
aaaaaaaaaaaaaaaaaaaaaaaaaaaaaaaaaaaaaaaaaaaaaaaaaaaaaaaaaaaaaaaaaaaaaaaaaaaaaaaaaaaaaaaaaaaaaaaaaaaaaaaaaaaaaaaaaaaaaaaaaaaaaaaaaaaaaaaaaaaaaaaaaaaaaa
aaaaaaaaaaaaaaaaaaaaaaaaaaaaaaaaaaaaaaaaaaaaaaaaaaaaaaaaaaaaaaaaaaaaaaaaaaaaaaaaaaaaaaaaaaaaaaaaaaaaaaaaaaaaaaaaaaaaaaaaaaaaaaaaaaaaaaaaaaaaaaaaaaaaaa
aaaaaaaaaaaaaaaaaaaaaaaaaaaaaaaaaaaaaaaaaaaaaaaaaaaaaaaaaaaaaaaaaaaaaaaaaaaaaaaaaaaaaaaaaaaaaaaaaaaaaaaaaaaaaaaaaaaaaaaaaaaaaaaaaaaaaaaaaaaaaaaaaaaaaa
aaaaaaaaaaaaaaaaaaaaaaaaaaaaaaaaaaaaaaaaaaaaaaaaaaaaaaaaaaaaaaaaaaaaaaaaaaaaaaaaaaaaaaaaaaaaaaaaaaaaaaaaaaaaaaaaaaaaaaaaaaaaaaaaaaaaaaaaaaaaaaaaaaaaaa
aaaaaaaaaaaaaaaaaaaaaaaaaaaaaaaaaaaaaaaaaaaaaaaaaaaaaaaaaaaaaaaaaaaaaaaaaaaaaaaaaaaaaaaaaaaaaaaaaaaaaaaaaaaaaaaaaaaaaaaaaaaaaaaaaaaaaaaaaaaaaaaaaaaaaa
aaaaaaaaaaaaaaaaaaaaaaaaaaaaaaaaaaaaaaaaaaaaaaaaaaaaaaaaaaaaaaaaaaaaaaaaaaaaaaaaaaaaaaaaaaaaaaaaaaaaaaaaaaaaaaaaaaaaaaaaaaaaaaaaaaaaaaaaaaaaaaaaaaaaaa
aaaaaaaaaaaaaaaaaaaaaaaaaaaaaaaaaaaaaaaaaaaaaaaaaaaaaaaaaaaaaaaaaaaaaaaaaaaaaaaaaaaaaaaaaaaaaaaaaaaaaaaaaaaaaaaaaaaaaaaaaaaaaaaaaaaaaaaaaaaaaaaaaaaaaa
aaaaaaaaaaaaaaaaaaaaaaaaaaaaaaaaaaaaaaaaaaaaaaaaaaaaaaaaaaaaaaaaaaaaaaaaaaaaaaaaaaaaaaaaaaaaaaaaaaaaaaaaaaaaaaaaaaaaaaaaaaaaaaaaaaaaaaaaaaaaaaaaaaaaaa
aaaaaaaaaaaaaaaaaaaaaaaaaaaaaaaaaaaaaaaaaaaaaaaaaaaaaaaaaaaaaaaaaaaaaaaaaaaaaaaaaaaaaaaaaaaaaaaaaaaaaaaaaaaaaaaaaaaaaaaaaaaaaaaaaaaaaaaaaaaaaaaaaaaaaa
aaaaaaaaaaaaaaaaaaaaaaaaaaaaaaaaaaaaaaaaaaaaaaaaaaaaaaaaaaaaaaaaaaaaaaaaaaaaaaaaaaaaaaaaaaaaaaaaaaaaaaaaaaaaaaaaaaaaaaaaaaaaaaaaaaaaaaaaaaaaaaaaaaaaaa
aaaaaaaaaaaaaaaaaaaaaaaaaaaaaaaaaaaaaaaaaaaaaaaaaaaaaaaaaaaaaaaaaaaaaaaaaaaaaaaaaaaaaaaaaaaaaaaaaaaaaaaaaaaaaaaaaaaaaaaaaaaaaaaaaaaaaaaaaaaaaaaaaaaaaa
aaaaaaaaaaaaaaaaaaaaaaaaaaaaaaaaaaaaaaaaaaaaaaaaaaaaaaaaaaaaaaaaaaaaaaaaaaaaaaaaaaaaaaaaaaaaaaaaaaaaaaaaaaaaaaaaaaaaaaaaaaaaaaaaaaaaaaaaaaaaaaaaaaaaaa
aaaaaaaaaaaaaaaaaaaaaaaaaaaaaaaaaaaaaaaaaaaaaaaaaaaaaaaaaaaaaaaaaaaaaaaaaaaaaaaaaaaaaaaaaaaaaaaaaaaaaaaaaaaaaaaaaaaaaaaaaaaaaaaaaaaaaaaaaaaaaaaaaaaaaa
aaaaaaaaaaaaaaaaaaaaaaaaaaaaaaaaaaaaaaaaaaaaaaaaaaaaaaaaaaaaaaaaaaaaaaaaaaaaaaaaaaaaaaaaaaaaaaaaaaaaaaaaaaaaaaaaaaaaaaaaaaaaaaaaaaaaaaaaaaaaaaaaaaaaaa
aaaaaaaaaaaaaaaaaaaaaaaaaaaaaaaaaaaaaaaaaaaaaaaaaaaaaaaaaaaaaaaaaaaaaaaaaaaaaaaaaaaaaaaaaaaaaaaaaaaaaaaaaaaaaaaaaaaaaaaaaaaaaaaaaaaaaaaaaaaaaaaaaaaaaa
aaaaaaaaaaaaaaaaaaaaaaaaaaaaaaaaaaaaaaaaaaaaaaaaaaaaaaaaaaaaaaaaaaaaaaaaaaaaaaaaaaaaaaaaaaaaaaaaaaaaaaaaaaaaaaaaaaaaaaaaaaaaaaaaaaaaaaaaaaaaaaaaaaaaaa
aaaaaaaaaaaaaaaaaaaaaaaaaaaaaaaaaaaaaaaaaaaaaaaaaaaaaaaaaaaaaaaaaaaaaaaaaaaaaaaaaaaaaaaaaaaaaaaaaaaaaaaaaaaaaaaaaaaaaaaaaaaaaaaaaaaaaaaaaaaaaaaaaaaaaa
aaaaaaaaaaaaaaaaaaaaaaaaaaaaaaaaaaaaaaaaaaaaaaaaaaaaaaaaaaaaaaaaaaaaaaaaaaaaaaaaaaaaaaaaaaaaaaaaaaaaaaaaaaaaaaaaaaaaaaaaaaaaaaaaaaaaaaaaaaaaaaaaaaaaaa
aaaaaaaaaaaaaaaaaaaaaaaaaaaaaaaaaaaaaaaaaaaaaaaaaaaaaaaaaaaaaaaaaaaaaaaaaaaaaaaaaaaaaaaaaaaaaaaaaaaaaaaaaaaaaaaaaaaaaaaaaaaaaaaaaaaaaaaaaaaaaaaaaaaaaa
aaaaaaaaaaaaaaaaaaaaaaaaaaaaaaaaaaaaaaaaaaaaaaaaaaaaaaaaaaaaaaaaaaaaaaaaaaaaaaaaaaaaaaaaaaaaaaaaaaaaaaaaaaaaaaaaaaaaaaaaaaaaaaaaaaaaaaaaaaaaaaaaaaaaaa
aaaaaaaaaaaaaaaaaaaaaaaaaaaaaaaaaaaaaaaaaaaaaaaaaaaaaaaaaaaaaaaaaaaaaaaaaaaaaaaaaaaaaaaaaaaaaaaaaaaaaaaaaaaaaaaaaaaaaaaaaaaaaaaaaaaaaaaaaaaaaaaaaaaaaa
aaaaaaaaaaaaaaaaaaaaaaaaaaaaaaaaaaaaaaaaaaaaaaaaaaaaaaaaaaaaaaaaaaaaaaaaaaaaaaaaaaaaaaaaaaaaaaaaaaaaaaaaaaaaaaaaaaaaaaaaaaaaaaaaaaaaaaaaaaaaaaaaaaaaaa
aaaaaaaaaaaaaaaaaaaaaaaaaaaaaaaaaaaaaaaaaaaaaaaaaaaaaaaaaaaaaaaaaaaaaaaaaaaaaaaaaaaaaaaaaaaaaaaaaaaaaaaaaaaaaaaaaaaaaaaaaaaaaaaaaaaaaaaaaaaaaaaaaaaaaa
aaaaaaaaaaaaaaaaaaaaaaaaaaaaaaaaaaaaaaaaaaaaaaaaaaaaaaaaaaaaaaaaaaaaaaaaaaaaaaaaaaaaaaaaaaaaaaaaaaaaaaaaaaaaaaaaaaaaaeababababababaaaaaaaaaaaaaaaaaaaa
aaaaaaaaaaaaaaaaaaaaaaaaabababababababababababababababababababababababababababababababababaeaeaeababaeaeaeaeaeaeaeaeababacadafagabaaaaaaaaaaaaaaaaaaaa
aaaaaaaaaaaaaaaaaaaaaaaaabahahaiaiaiaiaiaiaiaiaiajajajajajajajajajajajajajajajajajajajajabaaaeaaaeaeaaaeaaaeaaaeaeabababacafafagabaaaaaaaaaaaaaaaaaaaa
aaaaaaaaaaaaaaaaaaaaaaaaabahahaiakakakakakakakalajajajajajajajajajajajajajajajajajajajajabaaabaeaeaeaeabaaabababababababacafafagabababababaaaaaaaaaaaa
aaaaaaaaaaaaaaaaaaaaaaaaabahahaiakakamamamakakaiajajajajajajajajajajajajajajajajajajajajabaeaeaeaeaeaeaeaeabanananananababaoapababaqaqarasaaaaaaaaaaaa
aaaaaaaaaaaaaaaaaaaaaaaaabaiataiaiaiauauauaiaiaiajajajajajajajaiajajajajajajajaiajajajajabaeaeaeaeaeaeaeaeabanananananabavavavavabawahawasaaaaaaaaaaaa
aaaaaaaaaaaaaaaaaaaaaaaaabahahaiaxamamamamamamalajajajajajajajaiajajajajajajajaiajajajajabababayayayayabababanananananabavazazavabaAahawasaaaaaaaaaaaa
aaaaaaaaaaaaaaaaaaaaaaaaabahahaiaxakaBaiaxakamaiajajajajajajajajajajajajajajajajajajajajaCazazazazazazazazaCanananananaDavazazavabaAahawasaaaaaaaaaaaa
aaaaaaaaaaaaaaaaaaaaaaaaabaiataiaxakaBaiaxakaBaiajajajajajajajajajajajajajajajajajajajajabayayayayayayayayabanananananabavazazavabaAahawasaaaaaaaaaaaa
aaaaaaaaaaaaaaaaaaaaaaaaabahahaEamamamamamamaBaiajajajajajajajajajajajajajajajajajajajajayaaaaaaaaaaaaaaaaabababaDabababavazazavaFahaGaHabaaaaaaaaaaaa
aaaaaaaaaaaaaaaaaaaaaaaaabaiataiaiaiaiaiaiaiaiaiaiaiaiaiaiaiaiaiaiaiaiaiaiaiaiaiaiaiaiaIabayayayayayayayayabazazazazazabavazazavabaAahawasaaaaaaaaaaaa
aaaaaaaaaaaaaaaaaaaaaaaaabahahaiaJaJajajajajaKaLajajajajaMaNajajajajaOaPajajajajaQaiajajaCazazazazazazazazaCazazazazazaDavazazavabaAahawasaaaaaaaaaaaa
aaaaaaaaaaaaaaaaaaaaaaaaabahahaiaRaSajajajajaTaUajajajajaVaWajajajajaPaPajajajajajaIajajabababayayayayabababazazazazazabavazazavabaAahawasaaaaaaaaaaaa
aaaaaaaaaaaaaaaaaaaaaaaaabaiataiajajajaiaiajajajajaiaiajajajajaiaiajajajajaiaiajajaiaiaiabaeaeaeaeaeaeaeaeabazazazazazabavavavavabawahawasaaaaaaaaaaaa
aaaaaaaaaaaaaaaaaaaaaaaaabahahaiajajajaiaiajajajajaiaiajajajajaiaiajajajajaiaiajajaXaXaXabaeaeaeaeaeaeaeaeabazazazazazababaYazababaZaZbaasaaaaaaaaaaaa
aaaaaaaaaaaaaaaaaaaaaaaaabahahaibbbbajajajajbcbdajajajajbebfajajajajbgbhajajajajajavavaXabaaabaeaeaeaeabaaabababababababazazazazabababababaaaaaaaaaaaa
aaaaaaaaaaaaaaaaaaaaaaaaabahahaibbbbajajajajbcavajajajajbibjajajajajbkavajajajajbhaXaXaXabaaaeaaaeaeaaaeaaaeaaaeaeabababazazazazabaaaaaaaaaaaaaaaaaaaa
aaaaaaaaaaaaaaaaaaaaaaaaabababababababababababababababababababababababababababababababababaeaeaeababaeaeaeaeaeaeaeaeababazazazazabaaaaaaaaaaaaaaaaaaaa
aaaaaaaaaaaaaaaaaaaaaaaaaaaaaaaaaaaaaaaaaaaaaaaaaaaaaaaaaaaaaaaaaaaaaaaaaaaaaaaaaaaaaaaaaaaaaaaaaaaaaaaaaaaaaaaaaaaaaeababababababaaaaaaaaaaaaaaaaaaaa
aaaaaaaaaaaaaaaaaaaaaaaaaaaaaaaaaaaaaaaaaaaaaaaaaaaaaaaaaaaaaaaaaaaaaaaaaaaaaaaaaaaaaaaaaaaaaaaaaaaaaaaaaaaaaaaaaaaaaaaaaaaaaaaaaaaaaaaaaaaaaaaaaaaaaa
aaaaaaaaaaaaaaaaaaaaaaaaaaaaaaaaaaaaaaaaaaaaaaaaaaaaaaaaaaaaaaaaaaaaaaaaaaaaaaaaaaaaaaaaaaaaaaaaaaaaaaaaaaaaaaaaaaaaaaaaaaaaaaaaaaaaaaaaaaaaaaaaaaaaaa
aaaaaaaaaaaaaaaaaaaaaaaaaaaaaaaaaaaaaaaaaaaaaaaaaaaaaaaaaaaaaaaaaaaaaaaaaaaaaaaaaaaaaaaaaaaaaaaaaaaaaaaaaaaaaaaaaaaaaaaaaaaaaaaaaaaaaaaaaaaaaaaaaaaaaa
aaaaaaaaaaaaaaaaaaaaaaaaaaaaaaaaaaaaaaaaaaaaaaaaaaaaaaaaaaaaaaaaaaaaaaaaaaaaaaaaaaaaaaaaaaaaaaaaaaaaaaaaaaaaaaaaaaaaaaaaaaaaaaaaaaaaaaaaaaaaaaaaaaaaaa
aaaaaaaaaaaaaaaaaaaaaaaaaaaaaaaaaaaaaaaaaaaaaaaaaaaaaaaaaaaaaaaaaaaaaaaaaaaaaaaaaaaaaaaaaaaaaaaaaaaaaaaaaaaaaaaaaaaaaaaaaaaaaaaaaaaaaaaaaaaaaaaaaaaaaa
aaaaaaaaaaaaaaaaaaaaaaaaaaaaaaaaaaaaaaaaaaaaaaaaaaaaaaaaaaaaaaaaaaaaaaaaaaaaaaaaaaaaaaaaaaaaaaaaaaaaaaaaaaaaaaaaaaaaaaaaaaaaaaaaaaaaaaaaaaaaaaaaaaaaaa
aaaaaaaaaaaaaaaaaaaaaaaaaaaaaaaaaaaaaaaaaaaaaaaaaaaaaaaaaaaaaaaaaaaaaaaaaaaaaaaaaaaaaaaaaaaaaaaaaaaaaaaaaaaaaaaaaaaaaaaaaaaaaaaaaaaaaaaaaaaaaaaaaaaaaa
aaaaaaaaaaaaaaaaaaaaaaaaaaaaaaaaaaaaaaaaaaaaaaaaaaaaaaaaaaaaaaaaaaaaaaaaaaaaaaaaaaaaaaaaaaaaaaaaaaaaaaaaaaaaaaaaaaaaaaaaaaaaaaaaaaaaaaaaaaaaaaaaaaaaaa
aaaaaaaaaaaaaaaaaaaaaaaaaaaaaaaaaaaaaaaaaaaaaaaaaaaaaaaaaaaaaaaaaaaaaaaaaaaaaaaaaaaaaaaaaaaaaaaaaaaaaaaaaaaaaaaaaaaaaaaaaaaaaaaaaaaaaaaaaaaaaaaaaaaaaa
aaaaaaaaaaaaaaaaaaaaaaaaaaaaaaaaaaaaaaaaaaaaaaaaaaaaaaaaaaaaaaaaaaaaaaaaaaaaaaaaaaaaaaaaaaaaaaaaaaaaaaaaaaaaaaaaaaaaaaaaaaaaaaaaaaaaaaaaaaaaaaaaaaaaaa
aaaaaaaaaaaaaaaaaaaaaaaaaaaaaaaaaaaaaaaaaaaaaaaaaaaaaaaaaaaaaaaaaaaaaaaaaaaaaaaaaaaaaaaaaaaaaaaaaaaaaaaaaaaaaaaaaaaaaaaaaaaaaaaaaaaaaaaaaaaaaaaaaaaaaa
aaaaaaaaaaaaaaaaaaaaaaaaaaaaaaaaaaaaaaaaaaaaaaaaaaaaaaaaaaaaaaaaaaaaaaaaaaaaaaaaaaaaaaaaaaaaaaaaaaaaaaaaaaaaaaaaaaaaaaaaaaaaaaaaaaaaaaaaaaaaaaaaaaaaaa
aaaaaaaaaaaaaaaaaaaaaaaaaaaaaaaaaaaaaaaaaaaaaaaaaaaaaaaaaaaaaaaaaaaaaaaaaaaaaaaaaaaaaaaaaaaaaaaaaaaaaaaaaaaaaaaaaaaaaaaaaaaaaaaaaaaaaaaaaaaaaaaaaaaaaa
aaaaaaaaaaaaaaaaaaaaaaaaaaaaaaaaaaaaaaaaaaaaaaaaaaaaaaaaaaaaaaaaaaaaaaaaaaaaaaaaaaaaaaaaaaaaaaaaaaaaaaaaaaaaaaaaaaaaaaaaaaaaaaaaaaaaaaaaaaaaaaaaaaaaaa
aaaaaaaaaaaaaaaaaaaaaaaaaaaaaaaaaaaaaaaaaaaaaaaaaaaaaaaaaaaaaaaaaaaaaaaaaaaaaaaaaaaaaaaaaaaaaaaaaaaaaaaaaaaaaaaaaaaaaaaaaaaaaaaaaaaaaaaaaaaaaaaaaaaaaa
aaaaaaaaaaaaaaaaaaaaaaaaaaaaaaaaaaaaaaaaaaaaaaaaaaaaaaaaaaaaaaaaaaaaaaaaaaaaaaaaaaaaaaaaaaaaaaaaaaaaaaaaaaaaaaaaaaaaaaaaaaaaaaaaaaaaaaaaaaaaaaaaaaaaaa
aaaaaaaaaaaaaaaaaaaaaaaaaaaaaaaaaaaaaaaaaaaaaaaaaaaaaaaaaaaaaaaaaaaaaaaaaaaaaaaaaaaaaaaaaaaaaaaaaaaaaaaaaaaaaaaaaaaaaaaaaaaaaaaaaaaaaaaaaaaaaaaaaaaaaa
aaaaaaaaaaaaaaaaaaaaaaaaaaaaaaaaaaaaaaaaaaaaaaaaaaaaaaaaaaaaaaaaaaaaaaaaaaaaaaaaaaaaaaaaaaaaaaaaaaaaaaaaaaaaaaaaaaaaaaaaaaaaaaaaaaaaaaaaaaaaaaaaaaaaaa
aaaaaaaaaaaaaaaaaaaaaaaaaaaaaaaaaaaaaaaaaaaaaaaaaaaaaaaaaaaaaaaaaaaaaaaaaaaaaaaaaaaaaaaaaaaaaaaaaaaaaaaaaaaaaaaaaaaaaaaaaaaaaaaaaaaaaaaaaaaaaaaaaaaaaa
aaaaaaaaaaaaaaaaaaaaaaaaaaaaaaaaaaaaaaaaaaaaaaaaaaaaaaaaaaaaaaaaaaaaaaaaaaaaaaaaaaaaaaaaaaaaaaaaaaaaaaaaaaaaaaaaaaaaaaaaaaaaaaaaaaaaaaaaaaaaaaaaaaaaaa
aaaaaaaaaaaaaaaaaaaaaaaaaaaaaaaaaaaaaaaaaaaaaaaaaaaaaaaaaaaaaaaaaaaaaaaaaaaaaaaaaaaaaaaaaaaaaaaaaaaaaaaaaaaaaaaaaaaaaaaaaaaaaaaaaaaaaaaaaaaaaaaaaaaaaa
aaaaaaaaaaaaaaaaaaaaaaaaaaaaaaaaaaaaaaaaaaaaaaaaaaaaaaaaaaaaaaaaaaaaaaaaaaaaaaaaaaaaaaaaaaaaaaaaaaaaaaaaaaaaaaaaaaaaaaaaaaaaaaaaaaaaaaaaaaaaaaaaaaaaaa
aaaaaaaaaaaaaaaaaaaaaaaaaaaaaaaaaaaaaaaaaaaaaaaaaaaaaaaaaaaaaaaaaaaaaaaaaaaaaaaaaaaaaaaaaaaaaaaaaaaaaaaaaaaaaaaaaaaaaaaaaaaaaaaaaaaaaaaaaaaaaaaaaaaaaa
aaaaaaaaaaaaaaaaaaaaaaaaaaaaaaaaaaaaaaaaaaaaaaaaaaaaaaaaaaaaaaaaaaaaaaaaaaaaaaaaaaaaaaaaaaaaaaaaaaaaaaaaaaaaaaaaaaaaaaaaaaaaaaaaaaaaaaaaaaaaaaaaaaaaaa
aaaaaaaaaaaaaaaaaaaaaaaaaaaaaaaaaaaaaaaaaaaaaaaaaaaaaaaaaaaaaaaaaaaaaaaaaaaaaaaaaaaaaaaaaaaaaaaaaaaaaaaaaaaaaaaaaaaaaaaaaaaaaaaaaaaaaaaaaaaaaaaaaaaaaa
aaaaaaaaaaaaaaaaaaaaaaaaaaaaaaaaaaaaaaaaaaaaaaaaaaaaaaaaaaaaaaaaaaaaaaaaaaaaaaaaaaaaaaaaaaaaaaaaaaaaaaaaaaaaaaaaaaaaaaaaaaaaaaaaaaaaaaaaaaaaaaaaaaaaaa
aaaaaaaaaaaaaaaaaaaaaaaaaaaaaaaaaaaaaaaaaaaaaaaaaaaaaaaaaaaaaaaaaaaaaaaaaaaaaaaaaaaaaaaaaaaaaaaaaaaaaaaaaaaaaaaaaaaaaaaaaaaaaaaaaaaaaaaaaaaaaaaaaaaaaa
aaaaaaaaaaaaaaaaaaaaaaaaaaaaaaaaaaaaaaaaaaaaaaaaaaaaaaaaaaaaaaaaaaaaaaaaaaaaaaaaaaaaaaaaaaaaaaaaaaaaaaaaaaaaaaaaaaaaaaaaaaaaaaaaaaaaaaaaaaaaaaaaaaaaaa
"}
