"aa" = (/turf/space,/area/space)
"ab" = (/turf/simulated/wall/r_wall/hull,/area/space)
"ac" = (/turf/simulated/wall/r_wall/hull,/area/om_ships/SBS)
"ad" = (/turf/simulated/floor/tiled,/area/om_ships/SBS)
"ae" = (/obj/structure/lattice,/turf/space,/area/space)
"af" = (/turf/simulated/wall/r_wall/prepainted,/area/om_ships/SBS)
"ag" = (/obj/machinery/door/airlock,/turf/simulated/floor/tiled,/area/om_ships/SBS)
"ah" = (/turf/simulated/floor/carpet,/area/om_ships/SBS)
"ai" = (/obj/machinery/door/airlock/multi_tile/civilian,/turf/simulated/floor/tiled,/area/om_ships/SBS)
"aj" = (/obj/machinery/cryopod{dir = 4},/turf/simulated/floor/tiled/white/monotile,/area/om_ships/SBS)
"ak" = (/obj/effect/landmark/start/ship_cargo_cap_civ,/turf/simulated/floor/tiled/white,/area/om_ships/SBS)
"al" = (/obj/machinery/atmospherics/unary/engine{dir = 8},/turf/simulated/wall/r_wall/hull,/area/om_ships/SBS)
"am" = (/obj/machinery/door/airlock/external/glass,/turf/simulated/floor/tiled,/area/om_ships/SBS)
"an" = (/obj/effect/landmark/start/ship_cap_civ,/turf/simulated/floor/tiled/white,/area/om_ships/SBS)
"ao" = (/obj/machinery/cryopod,/turf/simulated/floor/tiled/white/monotile,/area/om_ships/SBS)
"ap" = (/obj/effect/wallframe_spawn/reinforced,/turf/simulated/floor/tiled,/area/om_ships/SBS)
"aq" = (/turf/simulated/floor/tiled/techfloor,/area/om_ships/SBS)
"ar" = (/obj/machinery/door/airlock/civilian,/turf/simulated/floor/tiled,/area/om_ships/SBS)
"as" = (/turf/simulated/floor/tiled/techmaint,/area/om_ships/SBS)
"at" = (/turf/simulated/floor/tiled/dark/monotile,/area/om_ships/SBS)
"au" = (/obj/machinery/door/airlock/multi_tile/civilian,/turf/simulated/floor/tiled/white,/area/om_ships/SBS)
"av" = (/turf/simulated/floor/tiled/white,/area/om_ships/SBS)
"aw" = (/obj/machinery/atmospherics/pipe/tank/hydrogen,/turf/simulated/floor/tiled/techfloor,/area/om_ships/SBS)
"ax" = (/obj/machinery/atmospherics/pipe/simple/visible/fuel{dir = 6},/turf/simulated/floor/tiled/techfloor,/area/om_ships/SBS)
"ay" = (/obj/machinery/door/airlock/external/glass,/turf/simulated/floor/tiled/techfloor,/area/om_ships/SBS)
"az" = (/obj/structure/table/marble,/turf/simulated/floor/tiled/dark/monotile,/area/om_ships/SBS)
"aB" = (/obj/machinery/atmospherics/pipe/manifold/visible/fuel{dir = 8},/turf/simulated/floor/tiled/techfloor,/area/om_ships/SBS)
"aC" = (/obj/machinery/atmospherics/pipe/simple/visible/fuel,/turf/simulated/floor/tiled/techfloor,/area/om_ships/SBS)
"aD" = (/turf/simulated/floor/tiled/dark,/area/om_ships/SBS)
"aE" = (/obj/machinery/door/airlock/glass,/turf/simulated/floor/tiled/techfloor,/area/om_ships/SBS)
"aF" = (/obj/machinery/door/airlock/engineering,/turf/simulated/floor/tiled,/area/om_ships/SBS)
"aG" = (/obj/machinery/atmospherics/pipe/simple/visible/fuel{dir = 4},/turf/simulated/floor/tiled/techfloor,/area/om_ships/SBS)
"aH" = (/obj/machinery/atmospherics/pipe/manifold/visible/fuel{dir = 4},/turf/simulated/floor/tiled/techfloor,/area/om_ships/SBS)
"aI" = (/obj/machinery/door/airlock,/turf/simulated/floor/tiled/techmaint,/area/om_ships/SBS)
"aJ" = (/obj/structure/closet/boxinggloves,/turf/simulated/floor/tiled/monotile,/area/om_ships/SBS)
"aK" = (/obj/structure/closet/jcloset,/turf/simulated/floor/tiled/monotile,/area/om_ships/SBS)
"aL" = (/obj/structure/closet/lasertag/blue,/turf/simulated/floor/tiled/monotile,/area/om_ships/SBS)
"aM" = (/obj/structure/closet/wardrobe/xenos,/turf/simulated/floor/tiled/monotile,/area/om_ships/SBS)
"aN" = (/obj/structure/closet/wardrobe/chaplain_black,/turf/simulated/floor/tiled/monotile,/area/om_ships/SBS)
"aO" = (/obj/machinery/constructable_frame,/turf/simulated/floor/tiled/monotile,/area/om_ships/SBS)
"aP" = (/obj/machinery/floodlight,/turf/simulated/floor/tiled/monotile,/area/om_ships/SBS)
"aQ" = (/obj/machinery/autolathe,/turf/simulated/floor/tiled/monotile,/area/om_ships/SBS)
"aR" = (/obj/structure/closet/bombcloset,/turf/simulated/floor/tiled/monotile,/area/om_ships/SBS)
"aS" = (/obj/structure/closet/firecloset,/turf/simulated/floor/tiled/monotile,/area/om_ships/SBS)
"aT" = (/obj/structure/closet/lasertag/red,/turf/simulated/floor/tiled/monotile,/area/om_ships/SBS)
"aU" = (/obj/structure/closet/masks,/turf/simulated/floor/tiled/monotile,/area/om_ships/SBS)
"aV" = (/obj/structure/closet/wardrobe/pink,/turf/simulated/floor/tiled/monotile,/area/om_ships/SBS)
"aW" = (/obj/structure/closet/wardrobe/mixed,/turf/simulated/floor/tiled/monotile,/area/om_ships/SBS)
"aX" = (/obj/structure/table/rack,/obj/random,/turf/simulated/floor/tiled/monotile,/area/om_ships/SBS)
"aY" = (/obj/machinery/atmospherics/pipe/tank/hydrogen{dir = 1},/turf/simulated/floor/tiled/techfloor,/area/om_ships/SBS)
"aZ" = (/obj/machinery/atmospherics/pipe/simple/visible/fuel{dir = 5},/turf/simulated/floor/tiled/techfloor,/area/om_ships/SBS)
"ba" = (/obj/structure/ore_box,/turf/simulated/floor/tiled/monotile,/area/om_ships/SBS)
"bb" = (/obj/structure/closet/radiation,/turf/simulated/floor/tiled/monotile,/area/om_ships/SBS)
"bc" = (/obj/structure/closet/wardrobe/black,/turf/simulated/floor/tiled/monotile,/area/om_ships/SBS)
"bd" = (/obj/structure/closet/wardrobe/red,/turf/simulated/floor/tiled/monotile,/area/om_ships/SBS)
"be" = (/obj/structure/closet/wardrobe/suit,/turf/simulated/floor/tiled/monotile,/area/om_ships/SBS)
"bf" = (/obj/structure/skele_stand,/turf/simulated/floor/tiled/monotile,/area/om_ships/SBS)
"bg" = (/obj/structure/plushie,/turf/simulated/floor/tiled/monotile,/area/om_ships/SBS)
"bi" = (/obj/structure/closet/wardrobe/tactical,/turf/simulated/floor/tiled/monotile,/area/om_ships/SBS)
"bj" = (/obj/structure/closet/wardrobe/white,/turf/simulated/floor/tiled/monotile,/area/om_ships/SBS)
"bk" = (/obj/machinery/icecream_vat,/turf/simulated/floor/tiled/monotile,/area/om_ships/SBS)
"bl" = (/turf/simulated/floor/tiled/monotile,/area/om_ships/SBS)
"bm" = (/obj/structure/bed/chair{dir = 4},/turf/simulated/floor/tiled/dark/monotile,/area/om_ships/SBS)
"bn" = (/obj/structure/bed/chair{dir = 8},/turf/simulated/floor/tiled/dark/monotile,/area/om_ships/SBS)

(1,1,1) = {"
aaaaaaaaaaaaaaaaaaaaaaaaaaaaaaaaaaaaaaaaaaaaaaaaaaaaaaaaaaaaaaaaaaaaaaaaaaaaaaaaaaaaaaaaaaaaaaaaaaaaaaaaaaaaaaaaaaaaaaaaaaaaaaaaaaaaaaaaaaaaaaaaaaaaaa
aaaaaaaaaaaaaaaaaaaaaaaaaaaaaaaaaaaaaaaaaaaaaaaaaaaaaaaaaaaaaaaaaaaaaaaaaaaaaaaaaaaaaaaaaaaaaaaaaaaaaaaaaaaaaaaaaaaaaaaaaaaaaaaaaaaaaaaaaaaaaaaaaaaaaa
aaaaaaaaaaaaaaaaaaaaaaaaaaaaaaaaaaaaaaaaaaaaaaaaaaaaaaaaaaaaaaaaaaaaaaaaaaaaaaaaaaaaaaaaaaaaaaaaaaaaaaaaaaaaaaaaaaaaaaaaaaaaaaaaaaaaaaaaaaaaaaaaaaaaaa
aaaaaaaaaaaaaaaaaaaaaaaaaaaaaaaaaaaaaaaaaaaaaaaaaaaaaaaaaaaaaaaaaaaaaaaaaaaaaaaaaaaaaaaaaaaaaaaaaaaaaaaaaaaaaaaaaaaaaaaaaaaaaaaaaaaaaaaaaaaaaaaaaaaaaa
aaaaaaaaaaaaaaaaaaaaaaaaaaaaaaaaaaaaaaaaaaaaaaaaaaaaaaaaaaaaaaaaaaaaaaaaaaaaaaaaaaaaaaaaaaaaaaaaaaaaaaaaaaaaaaaaaaaaaaaaaaaaaaaaaaaaaaaaaaaaaaaaaaaaaa
aaaaaaaaaaaaaaaaaaaaaaaaaaaaaaaaaaaaaaaaaaaaaaaaaaaaaaaaaaaaaaaaaaaaaaaaaaaaaaaaaaaaaaaaaaaaaaaaaaaaaaaaaaaaaaaaaaaaaaaaaaaaaaaaaaaaaaaaaaaaaaaaaaaaaa
aaaaaaaaaaaaaaaaaaaaaaaaaaaaaaaaaaaaaaaaaaaaaaaaaaaaaaaaaaaaaaaaaaaaaaaaaaaaaaaaaaaaaaaaaaaaaaaaaaaaaaaaaaaaaaaaaaaaaaaaaaaaaaaaaaaaaaaaaaaaaaaaaaaaaa
aaaaaaaaaaaaaaaaaaaaaaaaaaaaaaaaaaaaaaaaaaaaaaaaaaaaaaaaaaaaaaaaaaaaaaaaaaaaaaaaaaaaaaaaaaaaaaaaaaaaaaaaaaaaaaaaaaaaaaaaaaaaaaaaaaaaaaaaaaaaaaaaaaaaaa
aaaaaaaaaaaaaaaaaaaaaaaaaaaaaaaaaaaaaaaaaaaaaaaaaaaaaaaaaaaaaaaaaaaaaaaaaaaaaaaaaaaaaaaaaaaaaaaaaaaaaaaaaaaaaaaaaaaaaaaaaaaaaaaaaaaaaaaaaaaaaaaaaaaaaa
aaaaaaaaaaaaaaaaaaaaaaaaaaaaaaaaaaaaaaaaaaaaaaaaaaaaaaaaaaaaaaaaaaaaaaaaaaaaaaaaaaaaaaaaaaaaaaaaaaaaaaaaaaaaaaaaaaaaaaaaaaaaaaaaaaaaaaaaaaaaaaaaaaaaaa
aaaaaaaaaaaaaaaaaaaaaaaaaaaaaaaaaaaaaaaaaaaaaaaaaaaaaaaaaaaaaaaaaaaaaaaaaaaaaaaaaaaaaaaaaaaaaaaaaaaaaaaaaaaaaaaaaaaaaaaaaaaaaaaaaaaaaaaaaaaaaaaaaaaaaa
aaaaaaaaaaaaaaaaaaaaaaaaaaaaaaaaaaaaaaaaaaaaaaaaaaaaaaaaaaaaaaaaaaaaaaaaaaaaaaaaaaaaaaaaaaaaaaaaaaaaaaaaaaaaaaaaaaaaaaaaaaaaaaaaaaaaaaaaaaaaaaaaaaaaaa
aaaaaaaaaaaaaaaaaaaaaaaaaaaaaaaaaaaaaaaaaaaaaaaaaaaaaaaaaaaaaaaaaaaaaaaaaaaaaaaaaaaaaaaaaaaaaaaaaaaaaaaaaaaaaaaaaaaaaaaaaaaaaaaaaaaaaaaaaaaaaaaaaaaaaa
aaaaaaaaaaaaaaaaaaaaaaaaaaaaaaaaaaaaaaaaaaaaaaaaaaaaaaaaaaaaaaaaaaaaaaaaaaaaaaaaaaaaaaaaaaaaaaaaaaaaaaaaaaaaaaaaaaaaaaaaaaaaaaaaaaaaaaaaaaaaaaaaaaaaaa
aaaaaaaaaaaaaaaaaaaaaaaaaaaaaaaaaaaaaaaaaaaaaaaaaaaaaaaaaaaaaaaaaaaaaaaaaaaaaaaaaaaaaaaaaaaaaaaaaaaaaaaaaaaaaaaaaaaaaaaaaaaaaaaaaaaaaaaaaaaaaaaaaaaaaa
aaaaaaaaaaaaaaaaaaaaaaaaaaaaaaaaaaaaaaaaaaaaaaaaaaaaaaaaaaaaaaaaaaaaaaaaaaaaaaaaaaaaaaaaaaaaaaaaaaaaaaaaaaaaaaaaaaaaaaaaaaaaaaaaaaaaaaaaaaaaaaaaaaaaaa
aaaaaaaaaaaaaaaaaaaaaaaaaaaaaaaaaaaaaaaaaaaaaaaaaaaaaaaaaaaaaaaaaaaaaaaaaaaaaaaaaaaaaaaaaaaaaaaaaaaaaaaaaaaaaaaaaaaaaaaaaaaaaaaaaaaaaaaaaaaaaaaaaaaaaa
aaaaaaaaaaaaaaaaaaaaaaaaaaaaaaaaaaaaaaaaaaaaaaaaaaaaaaaaaaaaaaaaaaaaaaaaaaaaaaaaaaaaaaaaaaaaaaaaaaaaaaaaaaaaaaaaaaaaaaaaaaaaaaaaaaaaaaaaaaaaaaaaaaaaaa
aaaaaaaaaaaaaaaaaaaaaaaaaaaaaaaaaaaaaaaaaaaaaaaaaaaaaaaaaaaaaaaaaaaaaaaaaaaaaaaaaaaaaaaaaaaaaaaaaaaaaaaaaaaaaaaaaaaaaaaaaaaaaaaaaaaaaaaaaaaaaaaaaaaaaa
aaaaaaaaaaaaaaaaaaaaaaaaaaaaaaaaaaaaaaaaaaaaaaaaaaaaaaaaaaaaaaaaaaaaaaaaaaaaaaaaaaaaaaaaaaaaaaaaaaaaaaaaaaaaaaaaaaaaaaaaaaaaaaaaaaaaaaaaaaaaaaaaaaaaaa
aaaaaaaaaaaaaaaaaaaaaaaaaaaaaaaaaaaaaaaaaaaaaaaaaaaaaaaaaaaaaaaaaaaaaaaaaaaaaaaaaaaaaaaaaaaaaaaaaaaaaaaaaaaaaaaaaaaaaaaaaaaaaaaaaaaaaaaaaaaaaaaaaaaaaa
aaaaaaaaaaaaaaaaaaaaaaaaaaaaaaaaaaaaaaaaaaaaaaaaaaaaaaaaaaaaaaaaaaaaaaaaaaaaaaaaaaaaaaaaaaaaaaaaaaaaaaaaaaaaaaaaaaaaaaaaaaaaaaaaaaaaaaaaaaaaaaaaaaaaaa
aaaaaaaaaaaaaaaaaaaaaaaaaaaaaaaaaaaaaaaaaaaaaaaaaaaaaaaaaaaaaaaaaaaaaaaaaaaaaaaaaaaaaaaaaaaaaaaaaaaaaaaaaaaaaaaaaaaaaaaaaaaaaaaaaaaaaaaaaaaaaaaaaaaaaa
aaaaaaaaaaaaaaaaaaaaaaaaaaaaaaaaaaaaaaaaaaaaaaaaaaaaaaaaaaaaaaaaaaaaaaaaaaaaaaaaaaaaaaaaaaaaaaaaaaaaaaaaaaaaaaaaaaaaaaaaaaaaaaaaaaaaaaaaaaaaaaaaaaaaaa
aaaaaaaaaaaaaaaaaaaaaaaaaaaaaaaaaaaaaaaaaaaaaaaaaaaaaaaaaaaaaaaaaaaaaaaaaaaaaaaaaaaaaaaaaaaaaaaaaaaaaaaaaaaaaaaaaaaaaaaaaaaaaaaaaaaaaaaaaaaaaaaaaaaaaa
aaaaaaaaaaaaaaaaaaaaaaaaaaaaaaaaaaaaaaaaaaaaaaaaaaaaaaaaaaaaaaaaaaaaaaaaaaaaaaaaaaaaaaaaaaaaaaaaaaaaaaaaaaaaaaaaaaaaaaaaaaaaaaaaaaaaaaaaaaaaaaaaaaaaaa
aaaaaaaaaaaaaaaaaaaaaaaaaaaaaaaaaaaaaaaaaaaaaaaaaaaaaaaaaaaaaaaaaaaaaaaaaaaaaaaaaaaaaaaaaaaaaaaaaaaaaaaaaaaaaaaaaaaaaaaaaaaaaaaaaaaaaaaaaaaaaaaaaaaaaa
aaaaaaaaaaaaaaaaaaaaaaaaaaaaaaaaaaaaaaaaaaaaaaaaaaaaaaaaaaaaaaaaaaaaaaaaaaaaaaaaaaaaaaaaaaaaaaaaaaaaaaaaaaaaaaaaaaaaaaaaaaaaaaaaaaaaaaaaaaaaaaaaaaaaaa
aaaaaaaaaaaaaaaaaaaaaaaaaaaaaaaaaaaaaaaaaaaaaaaaaaaaaaaaaaaaaaaaaaaaaaaaaaaaaaaaaaaaaaaaaaaaaaaaaaaaaaaaaaaaaaaaaaaaaeacacacacacacaaaaaaaaaaaaaaaaaaaa
aaaaaaaaaaaaaaaaaaaaaaaaacacacacacacacacacacacacacacacacacacacacacacacacacacacacacacacacacaeaeaeababaeaeaeaeaeaeaeaeacacajakanaoacaaaaaaaaaaaaaaaaaaaa
aaaaaaaaaaaaaaaaaaaaaaaaacaqaqafafafafafafafafafasasasasasasasasasasasasasasasasasasasasacaaaeaaaeaeaaaeaaaeaaaeaeacacacajananaoacaaaaaaaaaaaaaaaaaaaa
aaaaaaaaaaaaaaaaaaaaaaaaacaqaqafaDaDaDaDaDaDaDagasasasasasasasasasasasasasasasasasasasasacaaabaeaeaeaeabaaacacacacacacacajananaoacacacacacaaaaaaaaaaaa
aaaaaaaaaaaaaaaaaaaaaaaaacaqaqafaDaDatatataDaDafasasasasasasasasasasasasasasasasasasasasacaeaeaeaeaeaeaeaeacahahahahahacacauavacacawawaxalaaaaaaaaaaaa
aaaaaaaaaaaaaaaaaaaaaaaaacafayafafafazazazafafafasasasasasasasafasasasasasasasafasasasasacaeaeaeaeaeaeaeaeacahahahahahacblblblblacaBaqaBalaaaaaaaaaaaa
aaaaaaaaaaaaaaaaaaaaaaaaacaqaqafbmatatatatatatagasasasasasasasafasasasasasasasafasasasasacacacapapapapacacacahahahahahacbladadblacaCaqaBalaaaaaaaaaaaa
aaaaaaaaaaaaaaaaaaaaaaaaacaqaqafbmaDbnafbmaDatafasasasasasasasasasasasasasasasasasasasasamadadadadadadadadamahahahahaharbladadblacaCaqaBalaaaaaaaaaaaa
aaaaaaaaaaaaaaaaaaaaaaaaacafayafbmaDbnafbmaDbnafasasasasasasasasasasasasasasasasasasasasacapapapapapapapapacahahahahahacbladadblacaCaqaBalaaaaaaaaaaaa
aaaaaaaaaaaaaaaaaaaaaaaaacaqaqaEatatatatatatbnafasasasasasasasasasasasasasasasasasasasasapaaaaaaaaaaaaaaaaacacacaracacacbladadblaFaqaGaHacaaaaaaaaaaaa
aaaaaaaaaaaaaaaaaaaaaaaaacafayafafafafafafafafafafafafafafafafafafafafafafafafafafafafaIacapapapapapapapapacadadadadadacbladadblacaCaqaBalaaaaaaaaaaaa
aaaaaaaaaaaaaaaaaaaaaaaaacaqaqafaJaJasasasasaKaLasasasasaMaNasasasasaOaPasasasasaQafasasamadadadadadadadadamadadadadadarbladadblacaCaqaBalaaaaaaaaaaaa
aaaaaaaaaaaaaaaaaaaaaaaaacaqaqafaRaSasasasasaTaUasasasasaVaWasasasasaPaPasasasasasaIasasacacacapapapapacacacadadadadadacbladadblacaCaqaBalaaaaaaaaaaaa
aaaaaaaaaaaaaaaaaaaaaaaaacafayafasasasafafasasasasafafasasasasafafasasasasafafasasafafafacaeaeaeaeaeaeaeaeacadadadadadacblblblblacaBaqaBalaaaaaaaaaaaa
aaaaaaaaaaaaaaaaaaaaaaaaacaqaqafasasasafafasasasasafafasasasasafafasasasasafafasasaXaXaXacaeaeaeaeaeaeaeaeacadadadadadacacaiadacacaYaYaZalaaaaaaaaaaaa
aaaaaaaaaaaaaaaaaaaaaaaaacaqaqafbabaasasasasbbbcasasasasbdbeasasasasbfbgasasasasasblblaXacaaabaeaeaeaeabaaacacacacacacacadadadadacacacacacaaaaaaaaaaaa
aaaaaaaaaaaaaaaaaaaaaaaaacaqaqafbabaasasasasbbblasasasasbibjasasasasbkblasasasasbgaXaXaXacaaaeaaaeaeaaaeaaaeaaaeaeacacacadadadadacaaaaaaaaaaaaaaaaaaaa
aaaaaaaaaaaaaaaaaaaaaaaaacacacacacacacacacacacacacacacacacacacacacacacacacacacacacacacacacaeaeaeababaeaeaeaeaeaeaeaeacacadadadadacaaaaaaaaaaaaaaaaaaaa
aaaaaaaaaaaaaaaaaaaaaaaaaaaaaaaaaaaaaaaaaaaaaaaaaaaaaaaaaaaaaaaaaaaaaaaaaaaaaaaaaaaaaaaaaaaaaaaaaaaaaaaaaaaaaaaaaaaaaeacacacacacacaaaaaaaaaaaaaaaaaaaa
aaaaaaaaaaaaaaaaaaaaaaaaaaaaaaaaaaaaaaaaaaaaaaaaaaaaaaaaaaaaaaaaaaaaaaaaaaaaaaaaaaaaaaaaaaaaaaaaaaaaaaaaaaaaaaaaaaaaaaaaaaaaaaaaaaaaaaaaaaaaaaaaaaaaaa
aaaaaaaaaaaaaaaaaaaaaaaaaaaaaaaaaaaaaaaaaaaaaaaaaaaaaaaaaaaaaaaaaaaaaaaaaaaaaaaaaaaaaaaaaaaaaaaaaaaaaaaaaaaaaaaaaaaaaaaaaaaaaaaaaaaaaaaaaaaaaaaaaaaaaa
aaaaaaaaaaaaaaaaaaaaaaaaaaaaaaaaaaaaaaaaaaaaaaaaaaaaaaaaaaaaaaaaaaaaaaaaaaaaaaaaaaaaaaaaaaaaaaaaaaaaaaaaaaaaaaaaaaaaaaaaaaaaaaaaaaaaaaaaaaaaaaaaaaaaaa
aaaaaaaaaaaaaaaaaaaaaaaaaaaaaaaaaaaaaaaaaaaaaaaaaaaaaaaaaaaaaaaaaaaaaaaaaaaaaaaaaaaaaaaaaaaaaaaaaaaaaaaaaaaaaaaaaaaaaaaaaaaaaaaaaaaaaaaaaaaaaaaaaaaaaa
aaaaaaaaaaaaaaaaaaaaaaaaaaaaaaaaaaaaaaaaaaaaaaaaaaaaaaaaaaaaaaaaaaaaaaaaaaaaaaaaaaaaaaaaaaaaaaaaaaaaaaaaaaaaaaaaaaaaaaaaaaaaaaaaaaaaaaaaaaaaaaaaaaaaaa
aaaaaaaaaaaaaaaaaaaaaaaaaaaaaaaaaaaaaaaaaaaaaaaaaaaaaaaaaaaaaaaaaaaaaaaaaaaaaaaaaaaaaaaaaaaaaaaaaaaaaaaaaaaaaaaaaaaaaaaaaaaaaaaaaaaaaaaaaaaaaaaaaaaaaa
aaaaaaaaaaaaaaaaaaaaaaaaaaaaaaaaaaaaaaaaaaaaaaaaaaaaaaaaaaaaaaaaaaaaaaaaaaaaaaaaaaaaaaaaaaaaaaaaaaaaaaaaaaaaaaaaaaaaaaaaaaaaaaaaaaaaaaaaaaaaaaaaaaaaaa
aaaaaaaaaaaaaaaaaaaaaaaaaaaaaaaaaaaaaaaaaaaaaaaaaaaaaaaaaaaaaaaaaaaaaaaaaaaaaaaaaaaaaaaaaaaaaaaaaaaaaaaaaaaaaaaaaaaaaaaaaaaaaaaaaaaaaaaaaaaaaaaaaaaaaa
aaaaaaaaaaaaaaaaaaaaaaaaaaaaaaaaaaaaaaaaaaaaaaaaaaaaaaaaaaaaaaaaaaaaaaaaaaaaaaaaaaaaaaaaaaaaaaaaaaaaaaaaaaaaaaaaaaaaaaaaaaaaaaaaaaaaaaaaaaaaaaaaaaaaaa
aaaaaaaaaaaaaaaaaaaaaaaaaaaaaaaaaaaaaaaaaaaaaaaaaaaaaaaaaaaaaaaaaaaaaaaaaaaaaaaaaaaaaaaaaaaaaaaaaaaaaaaaaaaaaaaaaaaaaaaaaaaaaaaaaaaaaaaaaaaaaaaaaaaaaa
aaaaaaaaaaaaaaaaaaaaaaaaaaaaaaaaaaaaaaaaaaaaaaaaaaaaaaaaaaaaaaaaaaaaaaaaaaaaaaaaaaaaaaaaaaaaaaaaaaaaaaaaaaaaaaaaaaaaaaaaaaaaaaaaaaaaaaaaaaaaaaaaaaaaaa
aaaaaaaaaaaaaaaaaaaaaaaaaaaaaaaaaaaaaaaaaaaaaaaaaaaaaaaaaaaaaaaaaaaaaaaaaaaaaaaaaaaaaaaaaaaaaaaaaaaaaaaaaaaaaaaaaaaaaaaaaaaaaaaaaaaaaaaaaaaaaaaaaaaaaa
aaaaaaaaaaaaaaaaaaaaaaaaaaaaaaaaaaaaaaaaaaaaaaaaaaaaaaaaaaaaaaaaaaaaaaaaaaaaaaaaaaaaaaaaaaaaaaaaaaaaaaaaaaaaaaaaaaaaaaaaaaaaaaaaaaaaaaaaaaaaaaaaaaaaaa
aaaaaaaaaaaaaaaaaaaaaaaaaaaaaaaaaaaaaaaaaaaaaaaaaaaaaaaaaaaaaaaaaaaaaaaaaaaaaaaaaaaaaaaaaaaaaaaaaaaaaaaaaaaaaaaaaaaaaaaaaaaaaaaaaaaaaaaaaaaaaaaaaaaaaa
aaaaaaaaaaaaaaaaaaaaaaaaaaaaaaaaaaaaaaaaaaaaaaaaaaaaaaaaaaaaaaaaaaaaaaaaaaaaaaaaaaaaaaaaaaaaaaaaaaaaaaaaaaaaaaaaaaaaaaaaaaaaaaaaaaaaaaaaaaaaaaaaaaaaaa
aaaaaaaaaaaaaaaaaaaaaaaaaaaaaaaaaaaaaaaaaaaaaaaaaaaaaaaaaaaaaaaaaaaaaaaaaaaaaaaaaaaaaaaaaaaaaaaaaaaaaaaaaaaaaaaaaaaaaaaaaaaaaaaaaaaaaaaaaaaaaaaaaaaaaa
aaaaaaaaaaaaaaaaaaaaaaaaaaaaaaaaaaaaaaaaaaaaaaaaaaaaaaaaaaaaaaaaaaaaaaaaaaaaaaaaaaaaaaaaaaaaaaaaaaaaaaaaaaaaaaaaaaaaaaaaaaaaaaaaaaaaaaaaaaaaaaaaaaaaaa
aaaaaaaaaaaaaaaaaaaaaaaaaaaaaaaaaaaaaaaaaaaaaaaaaaaaaaaaaaaaaaaaaaaaaaaaaaaaaaaaaaaaaaaaaaaaaaaaaaaaaaaaaaaaaaaaaaaaaaaaaaaaaaaaaaaaaaaaaaaaaaaaaaaaaa
aaaaaaaaaaaaaaaaaaaaaaaaaaaaaaaaaaaaaaaaaaaaaaaaaaaaaaaaaaaaaaaaaaaaaaaaaaaaaaaaaaaaaaaaaaaaaaaaaaaaaaaaaaaaaaaaaaaaaaaaaaaaaaaaaaaaaaaaaaaaaaaaaaaaaa
aaaaaaaaaaaaaaaaaaaaaaaaaaaaaaaaaaaaaaaaaaaaaaaaaaaaaaaaaaaaaaaaaaaaaaaaaaaaaaaaaaaaaaaaaaaaaaaaaaaaaaaaaaaaaaaaaaaaaaaaaaaaaaaaaaaaaaaaaaaaaaaaaaaaaa
aaaaaaaaaaaaaaaaaaaaaaaaaaaaaaaaaaaaaaaaaaaaaaaaaaaaaaaaaaaaaaaaaaaaaaaaaaaaaaaaaaaaaaaaaaaaaaaaaaaaaaaaaaaaaaaaaaaaaaaaaaaaaaaaaaaaaaaaaaaaaaaaaaaaaa
aaaaaaaaaaaaaaaaaaaaaaaaaaaaaaaaaaaaaaaaaaaaaaaaaaaaaaaaaaaaaaaaaaaaaaaaaaaaaaaaaaaaaaaaaaaaaaaaaaaaaaaaaaaaaaaaaaaaaaaaaaaaaaaaaaaaaaaaaaaaaaaaaaaaaa
aaaaaaaaaaaaaaaaaaaaaaaaaaaaaaaaaaaaaaaaaaaaaaaaaaaaaaaaaaaaaaaaaaaaaaaaaaaaaaaaaaaaaaaaaaaaaaaaaaaaaaaaaaaaaaaaaaaaaaaaaaaaaaaaaaaaaaaaaaaaaaaaaaaaaa
aaaaaaaaaaaaaaaaaaaaaaaaaaaaaaaaaaaaaaaaaaaaaaaaaaaaaaaaaaaaaaaaaaaaaaaaaaaaaaaaaaaaaaaaaaaaaaaaaaaaaaaaaaaaaaaaaaaaaaaaaaaaaaaaaaaaaaaaaaaaaaaaaaaaaa
aaaaaaaaaaaaaaaaaaaaaaaaaaaaaaaaaaaaaaaaaaaaaaaaaaaaaaaaaaaaaaaaaaaaaaaaaaaaaaaaaaaaaaaaaaaaaaaaaaaaaaaaaaaaaaaaaaaaaaaaaaaaaaaaaaaaaaaaaaaaaaaaaaaaaa
aaaaaaaaaaaaaaaaaaaaaaaaaaaaaaaaaaaaaaaaaaaaaaaaaaaaaaaaaaaaaaaaaaaaaaaaaaaaaaaaaaaaaaaaaaaaaaaaaaaaaaaaaaaaaaaaaaaaaaaaaaaaaaaaaaaaaaaaaaaaaaaaaaaaaa
aaaaaaaaaaaaaaaaaaaaaaaaaaaaaaaaaaaaaaaaaaaaaaaaaaaaaaaaaaaaaaaaaaaaaaaaaaaaaaaaaaaaaaaaaaaaaaaaaaaaaaaaaaaaaaaaaaaaaaaaaaaaaaaaaaaaaaaaaaaaaaaaaaaaaa
aaaaaaaaaaaaaaaaaaaaaaaaaaaaaaaaaaaaaaaaaaaaaaaaaaaaaaaaaaaaaaaaaaaaaaaaaaaaaaaaaaaaaaaaaaaaaaaaaaaaaaaaaaaaaaaaaaaaaaaaaaaaaaaaaaaaaaaaaaaaaaaaaaaaaa
"}
